F       100,100,100
NO ./textures/game_texture/NO.xpm
SO ./textures/game_texture/WALL1.xpm
WE ./textures/game_texture/abdoo.xpm
EA ./textures/game_texture/EA.xpm
C 0,33,70








1111111111111111111111111111111111
1000000010000000000000010000001111
100000000001000S000000010000000001
1000000000000000000000000000000001
1111111111111111111111111111111111











